{archbishop1}	Archevêque du Royaume
{archbishop1_desc}	Ce prêtre est monté aux fonctions religieuses les plus hautes dans le Royaume. Il est vraiment un conseiller désintéressé, spirituel, sage pour le Roi.
{archbishop1_effects_desc}	+1 en piété, a plus de mouvement.
{archbishop2}	Archevêque du Royaume
{archbishop2_desc}	Ce prêtre est monté aux fonctions religieuses les plus hautes dans le Royaume.  Cependant, il y voit une occasion d'accomplir ses soifs de désirs terrestres et de pouvoir!
{archbishop2_effects_desc}	-2 en piété, a plus de mouvement.
{archbishop3}	Patriarche de l'Église Orthodoxe
{archbishop3_desc}	Ce prêtre est monté aux fonctions religieuses les plus hautes dans l'Empire Byzantin. Il est vraiment un conseiller désintéressé, spirituel, sage pour le Roi.
{archbishop3_effects_desc}	+2 en piété, a plus de mouvement.
{archbishop4}	Patriarche de l'Église Orthodoxe
{archbishop4_desc}	Ce prêtre est monté aux fonctions religieuses les plus hautes dans l'Empire Byzantine.  Cependant, il y voit une occasion d'accomplir ses soifs de désirs terrestres et de pouvoir!
{archbishop4_effects_desc}	-4 en piété, a plus de mouvement.
{assassingm}	Grand-maître des assassins
{assassingm_desc}	Cet homme n'est nullement différent d'un autre. Il a beaucoup de témoins qui jurent ce fait par la torture et la douleur de la mort. Regard ailleurs pour un homme de n'importe quelle condition.
{assassingm_effects_desc}	Augmente l'habilité et le mouvement.
{bookdekells}	Le Livre de Kell
{carnival}	Relations de Fête de Carnaval
{carnival_desc}	Une invitation au Carnaval, que cet homme peut arranger, peut mener à toutes sortes de choses... Si quelqu'un va disparaître dans un canal ... bien, une mort heureuse est une bonne mort.
{carnival_effects_desc}	+1 en compétence.
{chamberlain}	Lord High Chamberlain"
{chamberlain_desc}	Votre Chambellan, monseigneur, surveille votre ménage et affirme votre en autorité à ceux qui doivent se souvenir qui est responsable!
{chamberlain_effects_desc}	+1 en autorité.
{chancellor}	Lord High Chancellor
{chancellor_desc}	Votre Chancelier surveille le système de justice de la cour, monseigneur. Un homme avec lequel il ne faut pas être brouillé.
{chancellor_effects_desc}	+1 en loi.
{fastolf}	John Fastolf"
{fastolf_desc}	John Fastolf, un soldat anglais, est un Commandementant militaire remarquable, particulièrement en infanterie.
{fastolf_effects_desc}	Bonus en Commandementement d'infanterie et en moral
{heir_orb}	Héritier présomptif
{heir_orb_desc}	Le détenteur de cette promesse héritera du trône de votre Royaume.
{heir_orb_effects_desc}	+1 en loyauté
{hospitalgm}	Grand-maître des Chevaliers Hospitaliers
{hospitalgm_desc}	Cet homme, par la manœuvre politique judicieuse ou fidélité sérieuse à son Ordre, a impressionné ses camarades Chevaliers assez pour être élu comme leur Grand-maître.
{hospitalgm_effects_desc}	Augmente en commerce, en piété, en mouvement; augmentation en Commandementement, particulièrement en cavalerie. Cet homme n'est probablement pas facilement suborné. Comme tout le monde sait, les Grands-maîtres du Temple sont particulièrement effrayants dans le combat contre l'ennemi Musulman.
{kells_desc}	Ce livre glorieusement illuminé, fait du vélin le plus excellent, est inestimable.
{kells_effects_desc}	Augmente la piété.
{kingmaker1}	Faiseur de rois
{kingmaker1_desc}	La noblesse du Roi respecte cet homme qui a aidé le Roi à accéder au trône lors d'une succession contestée. Il est une éminence grise crainte et le Roi, son cher ami, est certainement à son écoute.
{kingmaker1_effects_desc}	+1 en autorité
{kingmaker2}	Faiseur de rois
{kingmaker2_desc}	Cet homme a aidé votre Roi à accéder au trône. Cependant les moyens qu'il a utilisés n'ont pas impressionné la Noblesse du Royaume. Il semble faible et le Roi plus faible encore.
{kingmaker2_effects_desc}	-2 en autorité
{kings_treasurer}	Trésorier royal
{kings_treasurer_desc}	Le propre trésorier du Roi est un homme avec des responsabilités énormes et des tentations énormes…
{kings_treasurer_effects_desc}	+5 % sur les taxes, Pourrait être suborné et l'accès à l'argent peut rendre un homme moins ... pieux.
{marshall}	Lord High Marshall"
{marshall_desc}	Le leader stoïque, discipliné de l'armée de sa Majesté. Il sera nommé Maître des chevaux pour vous, monseigneur, si vous avez progressé en équitation.
{marshall_effects_desc}	+ 1 en Commandementement d'infanterie, -5% sur les coûts de formation des unités d'infanterie
{moh_desc}	Nommé par votre Maréchal, cet homme surveille le programme d'élevage des chevaux du Royaume et des deficiers de cavalerie.
{moh_effects_desc}	+5 en mouvement, +1 en Commandementement de la cavalerie.
{moh}	Maître des chevaux
{privyseal_desc}	Le Conseillé privé peut être confié à un homme auquel vous avez confiance en ... ou espéreriez être capable de croire plus...
{privyseal_effects_desc}	 +1 en loyauté; affecte aussi la piété.
{privyseal}	Conseillé privé
{protector_desc}	Ce Roi est honoré par dessus tout les autres! Le Pape lui-même l'a déclaré le "Défenseur de la Foi". Peut il montrer la pitié du Lord.
{protector_effects_desc}	+3 en piété, +1 en autorité
{protector}	Défenseur de la Foi
{santiagogm_desc}	La démarche prdeonde de cet homme de cœur a été jugé juste par ses pairs du Saint Ordre de Santiago. Il a été élu pour les mener tous comme leur Grand-maître.
{santiagogm_effects_desc}	Augmentation en commerce, en piété, en mouvement; augmentation en Commandementement, particulièrement en cavalerie. Finalement, il est certain qu'il connaît les façons efficaces de se battre contre l'ennemi musulman.
{santiagogm}	Grand-maître des Chevaliers de Santiago
{seneschal_desc}	Le Sénéchal connaît tous votre patrimoine royal, leur capacité pour la production jusqu'à la moindre botte de foin et surveillera tous les prdeits de vos terres.
{seneschal_effects_desc}	+5% en commerce
{seneschal}	Sénéchal
{steward_desc}	Votre régisseur est le maître sur toute votre cour nommant des fonctionnaires. Il restera loyal envers vous jusqu'à la fin.
{steward_effects_desc}	Augmente la loyauté.
{steward}	Lord High Steward"
{templar_grandmaster_desc}	Le Grand maître du sceau est seul à assurer la garantie de l'Ordre. Il est utilisé pour valider des documents approuvés par l'Ordre et en outre, c'est une reconnaissance de l'authenticité d'un document.
{templar_grandmaster_effects_desc}	+2 en autorité, +1 en loyauté, +1 en noblesse
{templar_grandmaster}	Grand maître du sceau
{templar_jerusalem_desc}	C'est le grand trésorier de l'Ordre et le chef de la province de Terre Sainte. Il gére toutes les transactions financières de l'Ordre qu'elles aient été effectuées en Occident ou en Orient. Il a la mainmise sur la flotte du Temple car tous les échanges commerciaux transitent par le port d'Acre. Il s'occupe également de répartir les frères dans les forteresses ou les Commandementeries selon les besoins en hommes de celles-ci. Il est secondé par le drapier de l'ordre..
{templar_jerusalem_effects_desc}	+1 en loyauté, +1 en piété, +1 en Commandementement d'infanterie
{templar_jerusalem}	Commandementeur de la terre et du royaume de Jérusalem
{templar_knights_desc}	C'est en quelque sorte le lieutenant du maréchal. Il Commandemente un escadron de dix frères-chevaliers. Il peut présider le chapitre en l'absence du Commandementeur de la Terre ou du maréchal.
{templar_knights_effects_desc}	+1 en loyauté, +1 en Commandementement de cavalerie
{templar_knights}	Commandementeur des chevaliers
{templargm_desc}	Cet homme a démontré la fidélité absolue à la cause du temple et l'autorité de l'Ordre de Templiers. Il a assez impressionné ses camarades chevaliers pour être élu comme leur Grand-maître.
{templargm_effects_desc}	Augmente en commerce, en piété, en mouvement; augmentation en Commandementement, particulièrement en cavalerie. Cet homme n'est probablement pas facilement suborné. Comme tout le monde sait, les Grands-maîtres du Temple sont particulièrement effrayants dans le combat contre l'ennemi Musulman.
{templargm}	Grand-maître du Temple
{teutongm_desc}	Manœuvrant astucieusement le paysage politique changeant des états Féodaux allemands, d'une façon ou d'une autre cet homme s'est élevé au sommet de son grade de chevaliers. Il a été dûment élu le Grand-maître.
{teutongm_effects_desc}	Augmente en mouvement; augmentation en Commandementement de tous les soldats, quoique pas particulièrement les chevaliers. Cet homme n'est probablement pas facilement suborné. En menant une armée, cet homme est particulièrement vicieux contre des Païens.
{teutongm}	Grand-maître de l'Ordre des chevaliers teutoniques
{thiefgm_desc}	Cet espion s'est élevé dans les rangs pour être à la tête de la corporation d'élite du Royaume des yeux et des oreilles... ou comme vous dites donc vos propres espions…
{thiefgm_effects_desc}	Augmente l'habilité et le mouvement
{thiefgm}	Grand-maître des voleurs
{white_stallion_desc}	Un coursier élégant, beau et digne; il permet à son maître d'inspirer à ses hommes de grandes choses.
{white_stallion_effects_desc}	+1 en moral pour toutes les troupes présentes sur le champ de bataille.
{white_stallion}	Etalon blanc
{dearmad_mystras}	Doukas de Mystra
{dearmad_mystras_desc}	Ayant droit comme Seigneur de Mystra et de son puissant château.  Riche en commerce de la soie, mais cherche l’indépendance. La famille Doukas est une famille byzantine régna sur l'empire de 1059 à à 1081 et dont le nom devient avec le temps synonyme de noblesse.
{dearmad_mystras_effects_desc}	+5% sur les revenus provenant des taxes, augmentation en commerce aussi bien qu’en «d’autres» plans.
¬---------------
{king_konigsberg}	Duc de Kœnigsberg
{king_konigsberg_desc}	Ayant droit comme Seigneur de Kœnigsberg, ou montagne des rois, connu pour être un bastion contre les païens
{king_konigsberg_effects_desc}	+5% sur les revenus provenant des taxes, augmentation en piété, diminution en noblesse
¬---------------
{idearmad_mystras}	Emir de Mystra
{idearmad_mystras_desc}	Ayant droit comme Seigneur de Mystra et de son puissant château.  Riche en commerce de la soie, mais cherche l’indépendance.
{idearmad_mystras_effects_desc}	+5% sur les revenus provenant des taxes, augmentation en commerce aussi bien qu’en «d’autres» plans.
¬---------------
{iking_konigsberg}	Emir de Kœnigsberg
{iking_konigsberg_desc}	Ayant droit comme Seigneur de Kœnigsberg ou montagne des rois, connu pour être un bastion contre les païens
{iking_konigsberg_effects_desc}	+5% sur les revenus provenant des taxes, augmentation en piété, diminution en noblesse
¬---------------
{odearmad_mystras}	Catapan de Mystra
{odearmad_mystras_desc}	Ayant droit comme Seigneur de Mystra et de son puissant château.  Riche en commerce de la soie, mais cherche l’indépendance.
{odearmad_mystras_effects_desc}	+5% sur les revenus provenant des taxes, augmentation en commerce aussi bien qu’en «d’autres» plans.
¬---------------
¬BGR---
{warcouncil1}Membre du Conseil de Guerre
{warcouncil2}Membre du Conseil de Guerre
{warcouncil3}Membre du Conseil de Guerre
{war_council_desc}En tant que membre du Conseil de guerre c'est l'un des généraux les plus puissants et soutenus dans cette faction.
{war_council_effects_desc}Il est au rang  de chef de faction, il doit déléguer a cause de sa position, ce qui permet d'etre membre.
{warchest1}Professional Formation du personnel
{warchest2}Professional Formation du personnel
{warchest3}Professional Formation du personnel
{warchest4}Professional Formation du personnel
{war_chest_desc}Les membres du Conseil de guerre sont généralement allouées aux équipe de formation professionnelle du personnel. L'accès aux fonds de la trésorerie et des autorisations pour le recrutement et la formation, sauf s'il existe un dossier de désobéissance répétée.
{war_chest_effects_desc}Membres du Conseil de guerre pouvent transmettre leurs formation professionnelle au personnel de la discipline générale ou le gouverneur de recruter dans les villes, mais seulement les conseillers de guerre  peuvent les utiliser pour recruter dans les châteaux, de peur, qu'un générale de petit importance saisisse une telle forteresse pour lui-même.
{supplywagon1}	Chariot de ravitaillement
{resupply_train_desc}	La faction soutient un Chariot unique, destiné à fournir des approvisionnements additionnels pour l'armée principale. Le chef peut déléguer son Chariot de ravitaillement au autre général.
{resupply_train_effects_desc}	Un soutien général peut suivre l'armée principale avec des fournitures supplémentaires et de les transférer si nécessaire, pour le général de l'armée principale. L'armée principale peut également effectuer le Chariot de ravitaillement, mais il peut le ralentir. Reconstituer les stocks de ravitaillement dans les colonies ou les navires.
¬BGR---
{warcouncil1}Membre du Conseil de Guerre
{warcouncil2}Membre du Conseil de Guerre
{warcouncil3}Membre du Conseil de Guerre
{war_council_desc}En tant que membre du Conseil de la guerre c'est l'un des généraux les plus puissants et soutenus dans cette faction.
{war_council_effects_desc}Il devrais etre au rang  de chef de faction, il doit déléguer a cause de sa position, ce qui permet d'avoir autre membre.
{warchest1}Professional Formation du personnel
{warchest2}Professional Formation du personnel
{warchest3}Professional Formation du personnel
{warchest4}Professional Formation du personnel
{war_chest_desc}Les membres du Conseil de guerre sont généralement allouées aux équipe de formation professionnelle du personnel. L'accès aux fonds de la trésorerie et des autorisations pour le recrutement et la formation, sauf s'il existe un dossier de désobéissance répétée.
{war_chest_effects_desc}Membres du Conseil de guerre pouvent transmettre leurs formation professionnelle au personnel de la discipline générale ou le gouverneur de recruter dans les villes, mais seulement les conseillers de guerre  peuvent les utiliser pour recruter dans les châteaux, de peur, qu'un générale de petit importance saisisse une telle forteresse pour lui-même.
{supplywagon1}	Chariot de ravitaillement
{resupply_train_desc}	La faction soutient un Chariot unique, destiné à fournir des approvisionnements additionnels pour l'armée principale. Le chef peut déléguer son Chariot de ravitaillement au autre général.
{resupply_train_effects_desc}	Un soutien général peut suivre l'armée principale avec des fournitures supplémentaires et de les transférer si nécessaire, pour le général de l'armée principale. L'armée principale peut également effectuer le Chariot de ravitaillement, mais il peut le ralentir. Reconstituer les stocks de ravitaillement dans les colonies ou les navires.